ごうぎ	強氣	固有名詞
さなね	紗波音	固有名詞
はやて	疾風	固有名詞
りゅうじんきゃく	竜刃脚	固有名詞
りょうぶ	龍武	固有名詞
しんきはつどう	神気発動	固有名詞
まりゅうれっこう	魔龍裂光	固有名詞
もうりょうかせん	魍魎渦旋	固有名詞
しんきはつどうかい	神鬼発動改	固有名詞
さいろうきょうしゅ	豺狼兇手	固有名詞
がりゅうめっしゅう	雅竜滅蹴	固有名詞
ちゅうほう	肘崩	固有名詞
がいしゅう	刈蹴	固有名詞
ちゅうげきほう	肘激崩	固有名詞
しょうげきは	掌撃破	固有名詞
しんがいきゃく	振刈脚	固有名詞
しんきゃくげき	振脚撃	固有名詞
しょうりんげき	掌燐撃	固有名詞
かたち	貌	固有名詞
ごきゃくこう	護流攻	固有名詞
しん	振	固有名詞
りゅうすい	流水	固有名詞
きれんえき	気錬射	固有名詞
きゃくほうぎ	撃鳳技	固有名詞
れんしょうげき	連昇激	固有名詞
れんぶ	連舞	固有名詞
ざんき	斬鬼	固有名詞
きょうじゃ	狂蛇	固有名詞
きざん	鬼斬	固有名詞
ごうが	轟牙	固有名詞
しゅうが	襲牙	固有名詞
じゃざん	蛇斬	固有名詞
きえんぶ	鬼燕舞	固有名詞
きえんしょう	鬼燕翔	固有名詞
そうこんだん	蒼魂弾	固有名詞
だいかく	大覚	固有名詞
じょうじゅ	成就	固有名詞
たそがれらりあっと	黄昏ラリアット	固有名詞
ちょうぜつきしんぼむ	超絶鬼神ボム	固有名詞
いんどらばし	インドラ橋	固有名詞
いんどらーばし	インドラ〜橋	固有名詞
とうちゅうほう	踏肘崩	固有名詞
らくしちげき	落膝激	固有名詞
さんれんこん	三連棍	固有名詞
かすみおろし	霞颪	固有名詞
てんしょうこん	天昇棍	固有名詞
げっきょうぼたん	月鏡牡丹	固有名詞
いざよいれっこん	十六夜烈棍	固有名詞
やよいとうこんぎ	弥生投棍技	固有名詞
めいげつ	名月	固有名詞
ありあけ	有明	固有名詞
えんらくししょう	燕落紫昇	固有名詞
かまいたち	鎌鼬	固有名詞
おぼろづき	朧月	固有名詞
ひせんざん	飛旋斬	固有名詞
じょうわんがたばくらいは	上腕型/爆雷破	固有名詞
じょうわんがた	上腕型	固有名詞
ばくらいは	爆雷破	固有名詞
れっしんかまいたち	烈震鎌鼬	固有名詞
らいざんしょう	雷斬翔	固有名詞
つむじかげろうきょく	旋陽炎・極	固有名詞
